%%%%%%%%%%%%%%%%%%%%%%%%%%%%%%%%%%%%%
%o...........G....G.G..G...........o%
%.%%%.%.%.%%%.%%%.%.%.%.%.%.%%%.%.%.%
%..%..%.%.%.%.%.%.%.%%%.%.%.%.%.%.%.%
%..%..%%%.%%%.%.%.%.%...%%%.%.%.%.%.%
%..%..%.%.%.%.%.%.%.%%%..%..%.%.%.%.%
%..%..%.%.%.%.%.%%%.%.%..%..%%%.%%%.%
%o...........P.....................o%
%%%%%%%%%%%%%%%%%%%%%%%%%%%%%%%%%%%%%